########################################################
#......................................................#
#......................................................#
#......................................................#
#......................................................#
#.....................####.............................#
#...................#......#...........................#
#.................#..........#.........................#
#................#............#........................#
#.............................#........................#
#.............................#........................#
#.............................#........................#
#............................#.........................#
#.........................#............................#
#.......................#..............................#
#........................#.............................#
#..........................#...........................#
#............................#.........................#
#............................#.........................#
#............................#.........................#
#................#..........#..........................#
#.................#########............................#
#......................................................#
#......................................................#
#......................................................#
#......................................................#
#......................###########.....................#
#......................................................#
#......................................................#
#......................................................#
#......................................................#
#......................................................#
#.........###############..............................#
#......................................................#
#......................................................#
#......................................................#
#..........................#...........................#
#..........................#...........................#
#..........................#...........................#
#..........................#...........................#
#..........................#...........................#
#..........................#...........................#
#......................................................#
#......................................................#
#......................................................#
########################################################