########################################################
#......................................................#
#......................................................#
#......................................................#
#......................................................#
#.....................####.............................#
#...................#......#...........................#
#.................#..........#.........................#
#................#............#........................#
#.............................#........................#
#.............................#........................#
#.............................#........................#
#............................#.........................#
#...........................#..........................#
#.........................#............................#
#.......................#..............................#
#.....................#................................#
#...................#..................................#
#................#.....................................#
#..............#.......................................#
#..............#.......................................#
#..............#.......................................#
#..............#################.......................#
#......................................................#
#......................................................#
#......................................................#
#......................................................#
#......................................................#
#......................................................#
#......................................................#
#..............##########..............................#
#........................##########....................#
#......................................................#
#......................................................#
#......................................................#
#......................................................#
#......................................................#
#......................................................#
#................#.....................................#
#................#...........................######....#
#................#.....................................#
#................#.....................................#
#......................................................#
#......................................................#
#......................................................#
########################################################