####################################################
#..................................................#
#..................................................#
#..................................................#
#.........................#........................#
#........................##........................#
#.......................#.#........................#
#......................#..#........................#
#.....................#...#........................#
#....................#....#........................#
#...................#.....#........................#
#..................#......#........................#
#.........................#........................#
#.........................#........................#
#.........................#........................#
#.........................#........................#
#.........................#........................#
#.........................#........................#
#.........................#........................#
#...................##############.................#
#..................................................#
#..................................................#
#..................................................#
#............................#####.......####......#
#................................########..........#
#..................................................#
#..................................................#
#..................................................#
#...........#......................................#
#...........#......................................#
#...........#......................................#
#...........#......................................#
#...........#......................................#
#...........#......................................#
#...........#......................................#
#..................................................#
#..................................................#
#.........................##############...........#
#..................................................#
#..................................................#
#..................................................#
#..................................................#
#..................................................#
#..................................................#
#..................................................#
####################################################